10 10 3 60
##########
#/       #
#  #  #  #
#        #
#  #  #  #
#  @     #
#  #  #  #
#@@   !  #
# D# D# D#
##########