14 14 3 60
##############
#/          D#
#  ##     # @#
#  #    ###  #
#  #    #D   #
#  !   @  #  #
#  ###    #  #
#@     ####  #
#  #         #
#  #  @#  #  #
#  #  D#  #@@#
# @# ### ##  # 
#      !    D#
##############