15 15 7 100
###############
#/   DDDDDDDDD#
#D ####D#### D#
#D ####D####!D#
#DDD@DDDDDD@DD#
#D #### #### D#
#D ####@#### D#
#DD@DDDDDDDDDD#
#  @DDDD@@    #
#  #### ####  #
# %#### ####  #
#  @@@   @@@ !# 
#  @D@   @D@  #
#  @@@DDD@@@  #
###############

