19 19 8 120
###################
#/                #
#  #DD@          D#  
#  #     ####DDD  #   
#  #   #### ! #   #
#      D@@D       #
# D###  ###  ###  #
# D         @     #
# D#   ####    #  #
#  #   ####    #D #
#  #   ####    #D #
#   D@      %     #
# #### #### ####  #
# # D          #  #
# #  ### ###   #  #
#   @@      @  @  #
#  #  ######   #D #
#D #  D@DDD!   #D #
###################