19 19 2 130
###################
#/DDDDDDDDDDD@DDDD#
#D####D####D####DD#
#D####D####D####D@#
#D####D####D####DD#
#DDD%DDDDDDDDDDD@D#
#D####D####D####DD#
#D####D####D####DD#
#D####D####D####D@#
#DDDDD@DDDDDD%DDDD#
#D####D####D####DD#
#D####D####D####DD#
#D####D####D####@D#
#DD@DDDDDDDDDDDDDD#
#D####D####D####DD#
#D####D####D####DD#
#D####D####D####@D#
#!DDD@DDD%DDDDDDDD#
###################